width 28
height 31
data
1 8 8 8 8 8 8 8 8 8 8 8 8 16 15 8 8 8 8 8 8 8 8 8 8 8 8 2
5 0 0 0 0 0 0 0 0 0 0 0 0 23 24 0 0 0 0 0 0 0 0 0 0 0 0 6
5 0 18 22 22 17 0 18 22 22 22 17 0 23 24 0 18 22 22 22 17 0 18 22 22 17 0 6
5 0 23 0 0 24 0 23 0 0 0 24 0 23 24 0 23 0 0 0 24 0 23 0 0 24 0 6
5 0 19 21 21 20 0 19 21 21 21 20 0 19 20 0 19 21 21 21 20 0 19 21 21 20 0 6
5 0 0 0 0 0 0 0 0 0 0 0 0 0 0 0 0 0 0 0 0 0 0 0 0 0 0 6
5 0 18 22 22 17 0 18 17 0 18 22 22 22 22 22 22 17 0 18 17 0 18 22 22 17 0 6
5 0 19 21 21 20 0 23 24 0 19 21 21 34 35 21 21 20 0 23 24 0 19 21 21 20 0 6
5 0 0 0 0 0 0 23 24 0 0 0 0 23 24 0 0 0 0 23 24 0 0 0 0 0 0 6
4 7 7 7 7 17 0 23 33 22 22 17 0 23 24 0 18 22 22 36 24 0 18 7 7 7 7 3
0 0 0 0 0 5 0 23 35 21 21 20 0 19 20 0 19 21 21 34 24 0 6 0 0 0 0 0
0 0 0 0 0 5 0 23 24 0 0 0 0 0 0 0 0 0 0 23 24 0 6 0 0 0 0 0
0 0 0 0 0 5 0 23 24 0 30 7 25 31 31 26 7 27 0 23 24 0 6 0 0 0 0 0
8 8 8 8 8 20 0 19 20 0 6 0 0 0 0 0 0 5 0 19 20 0 19 8 8 8 8 8
0 0 0 0 0 0 0 0 0 0 6 0 0 0 0 0 0 5 0 0 0 0 0 0 0 0 0 0
7 7 7 7 7 17 0 18 17 0 6 0 0 0 0 0 0 5 0 18 17 0 18 7 7 7 7 7
0 0 0 0 0 5 0 23 24 0 29 8 8 8 8 8 8 28 0 23 24 0 6 0 0 0 0 0
0 0 0 0 0 5 0 23 24 0 0 0 0 0 0 0 0 0 0 23 24 0 6 0 0 0 0 0
0 0 0 0 0 5 0 23 24 0 18 22 22 22 22 22 22 17 0 23 24 0 6 0 0 0 0 0
1 8 8 8 8 20 0 19 20 0 19 21 21 34 35 21 21 20 0 19 20 0 19 8 8 8 8 2
5 0 0 0 0 0 0 0 0 0 0 0 0 23 24 0 0 0 0 0 0 0 0 0 0 0 0 6
5 0 18 22 22 17 0 18 22 22 22 17 0 23 24 0 18 22 22 22 17 0 18 22 22 17 0 6
5 0 19 21 34 24 0 19 21 21 21 20 0 19 20 0 19 21 21 21 20 0 23 35 21 20 0 6
5 0 0 0 23 24 0 0 0 0 0 0 0 0 0 0 0 0 0 0 0 0 23 24 0 0 0 6
9 22 17 0 23 24 0 18 17 0 18 22 22 22 22 22 22 17 0 18 17 0 23 24 0 18 22 14
10 21 20 0 19 20 0 23 24 0 19 21 21 34 35 21 21 20 0 23 24 0 19 20 0 19 21 13
5 0 0 0 0 0 0 23 24 0 0 0 0 23 24 0 0 0 0 23 24 0 0 0 0 0 0 6
5 0 18 22 22 22 22 36 33 22 22 17 0 23 24 0 18 22 22 36 33 22 22 22 22 17 0 6
5 0 19 21 21 21 21 21 21 21 21 20 0 19 20 0 19 21 21 21 21 21 21 21 21 20 0 6
5 0 0 0 0 0 0 0 0 0 0 0 0 0 0 0 0 0 0 0 0 0 0 0 0 0 0 6
4 7 7 7 7 7 7 7 7 7 7 7 7 7 7 7 7 7 7 7 7 7 7 7 7 7 7 3