width 8
height 6
data
2 0 4 5 6 7 0 9
0 0 0 0 0 0 0 0
9 0 9 9 9 9 0 9
9 0 9 9 9 9 0 9
9 0 0 0 0 0 0 9
9 0 9 9 9 9 0 9