width 16
height 8
data
9 9 9 9 9 9 9 9 9 9 9 9 9 9 9 9
9 0 0 0 0 0 0 0 0 0 0 0 0 0 0 9
9 0 0 0 0 0 0 0 0 0 0 0 0 0 0 9
9 0 0 0 0 0 0 0 0 9 9 0 0 0 0 9
9 0 0 0 9 9 0 0 0 0 0 0 0 0 0 9
9 9 9 0 0 0 0 9 9 0 0 0 9 9 0 9
9 9 9 0 0 0 9 9 9 0 0 0 0 0 0 9
9 9 9 9 9 9 9 9 9 9 9 9 9 9 9 9
